test
An Interactive Fiction by Daniele Maccari
Release 1 / Serial number 190526 / Inform 7 build 6M62 (I6/v6.33 lib 6/12N) SD

Bedroom
You are in your room. It's got a strange vibe, as if each of the previous tenants left something of their own in it. But you got used to it, and now it's just your room. You are sitting at your tiny desk -- some oddly shaped table from IKEA or something -- staring at some text on the screen of your laptop. You have been trying to read the same paragraph for the last five minutes, but the words seem to be slipping away from you as soon as you hop from one to the next while playing your inner monologue.  To your left, the only painted wall stands out lonely; it's a dark blue, although the hue is light enough for the color to still be recognizable, at least in daylight. From outside, you can hear some birds chirping, and sunlight glides in through the large, wall-wide window behind you, gifting your back with a nice, cozy feeling of warmth. To the east the only door leads to a small landing.

A plain-looking, creamy painted door leads  to the landing.

>x wall
The wall facing the entrance to the bedroom is painted a dark blue, and some abstract paintings from some unknown African artist are hanged above the bed.

>x landing
You can't see any such thing.

>e
Landing
A small landing providing access to the rooms on the second floor of the house. East you can see the bathroom, but the door is locked. You can hear the water in the shower running, but the light is off. Weird.

>l
Landing
A small landing providing access to the rooms on the second floor of the house. East you can see the bathroom, but the door is locked. You can hear the water in the shower running, but the light is off. Weird.

* * *

>x wall
The wall facing the entrance to the bedroom is painted a dark blue, and some abstract paintings from some unknown African artist are hanged above the bed.

>e
The Landing
A small landing providing access to the rooms on the second floor of the house. To the right you can see the bathroom; you can tell the door have been locked from the inside from the old-fashioned bolt lock. You can see no light coming from the small glass pane above the door. The light is off as well, but you can hear the water in the shower running. Weird.

A plain-looking, creamy painted door leads back to the bedroom.

Another door leads to the bathroom. You can see a bolt lock next to the handle.

>touch lock
You can't reach it from this side. What would be the point otherwise?

>turn
What do you want to turn?

>the lock
You can't reach it from this side. What would be the point otherwise?

* * *

>e
The Landing
A small landing providing access to the rooms on the second floor of the house. To the right you can see the bathroom; you can tell the door have been locked from the inside from the old-fashioned bolt lock. You can see no light coming from the small glass pane above the door. The light is off as well, but you can hear the water in the shower running. Weird.

A plain-looking, creamy painted door leads back to the bedroom.

Another door leads to the bathroom. You can see a bolt lock next to the handle.

>open door
You can't see any such thing.

>w
Bedroom
You are in your room. It's got a strange vibe, as if each of the previous tenants left something of their own in it. But you got used to it, and now it's just your room. You are sitting at your tiny desk -- some oddly shaped table from IKEA or something -- staring at some text on the screen of your laptop. You have been trying to read the same paragraph for the last five minutes, but the words seem to be slipping away from you as soon as you hop from one to the next while playing your inner monologue.  To your left, the only painted wall stands out lonely; it's a dark blue, although the hue is light enough for the color to still be recognizable, at least in daylight. From outside, you can hear some birds chirping, and sunlight glides in through the large, wall-wide window behind you, gifting your back with a nice, cozy feeling of warmth. To the east the only door leads to a small landing.

>e
Landing
A small landing providing access to the rooms on the second floor of the house. To the right you can see the bathroom, although you can see the door have been locked. You can see no light coming from the small glass pane above the door. They probably did not even bother to raise the shutter. The light is off as well, but you can hear the water in the shower running. Weird.

>mao
That's not a verb I recognise.

>map
That's not a verb I recognise.

* * *

>e
The Landing
A small landing providing access to the rooms on the second floor of the house. To the right you can see the bathroom; you can tell the door have been locked from the inside from the old-fashioned bolt lock. You can see no light coming from the small glass pane above the door. The light is off as well, but you can hear the water in the shower running. Weird.

A plain-looking, creamy painted door leads back to the bedroom.

Another door leads to the bathroom. You can see a bolt lock next to the handle.

>s
You can't go that way.

>open door
You open the Bedroom Door.

>e
You can't go that way.

>s
You can't go that way.

* * *

>e
The Landing
A small landing providing access to the rooms on the second floor of the house. To the right you can see the bathroom; you can tell the door have been locked from the inside from the old-fashioned bolt lock. You can see no light coming from the small glass pane above the door. The light is off as well, but you can hear the water in the shower running. Weird.

A plain-looking, creamy painted door leads back to the bedroom.

Another door leads to the bathroom. You can see a bolt lock next to the handle.

>close the door
You close the Bedroom Door.

>w
Bedroom
You are in your room. It's got a strange vibe, as if each of the previous tenants left something of their own in it. But you got used to it, and now it's just your room. You are sitting at your tiny desk -- some oddly shaped table from IKEA or something -- staring at some text on the screen of your laptop. You have been trying to read the same paragraph for the last five minutes, but the words seem to be slipping away from you as soon as you hop from one to the next while playing your inner monologue.  To your left, the only painted wall stands out lonely; it's a dark blue, although the hue is light enough for the color to still be recognizable, at least in daylight. From outside, you can hear some birds chirping, and sunlight glides in through the large, wall-wide window behind you, gifting your back with a nice, cozy feeling of warmth. To the east the only door leads to a small landing.

You can see a Bedroom Door here.

* * *

>e
The Landing
A small landing providing access to the rooms on the second floor of the house. To the right you can see the bathroom; you can tell the door have been locked from the inside from the old-fashioned bolt lock. You can see no light coming from the small glass pane above the door. The light is off as well, but you can hear the water in the shower running. Weird.

A plain-looking, creamy painted door leads back to the bedroom.

Another door leads to the bathroom. You can see a bolt lock next to the handle.

>w
Bedroom
You are in your room. It's got a strange vibe, as if each of the previous tenants left something of their own in it. But you got used to it, and now it's just your room. You are sitting at your tiny desk -- some oddly shaped table from IKEA or something -- staring at some text on the screen of your laptop. You have been trying to read the same paragraph for the last five minutes, but the words seem to be slipping away from you as soon as you hop from one to the next while playing your inner monologue.  To your left, the only painted wall stands out lonely; it's a dark blue, although the hue is light enough for the color to still be recognizable, at least in daylight. From outside, you can hear some birds chirping, and sunlight glides in through the large, wall-wide window behind you, gifting your back with a nice, cozy feeling of warmth. To the east the only door leads to a small landing.

You can see a Bedroom Door here.

>close door
You close the Bedroom Door.

>e
(first opening the Bedroom Door)

The Landing
A small landing providing access to the rooms on the second floor of the house. To the right you can see the bathroom; you can tell the door have been locked from the inside because the old-fashioned turning lock is set on red. You can see no light coming from the small glass pane above the door; they probably did not even bother to raise the shutter. The light is off as well, but you can hear the water in the shower running. Weird.

You can see a Bedroom Door here.

* * *

>e
The Landing
A small landing providing access to the rooms on the second floor of the house. To the right you can see the bathroom; you can tell the door have been locked from the inside from the old-fashioned bolt lock. You can see no light coming from the small glass pane above the door. The light is off as well, but you can hear the water in the shower running. Weird.

A plain-looking, creamy painted door leads back to the bedroom.

Another door leads to the bathroom. You can see a bolt lock next to the handle.

>e
The door is locked. You can hear the shower running, but no light is sifting through the door.

>x bathroom
You can't see any such thing.

>x door
Which do you mean, the bedroom door or the bathroom door?

>bathroom
You see nothing special about the bathroom door.

* * *

>e
The door is locked. You can hear the shower running, but no light is sifting through the door.

>unlock door
Which do you mean, the bedroom door or the bathroom's door?

>bathroom's
What do you want to unlock the bathroom's door with?

>nothing
You can't see any such thing.

* * *

>unlock door
Which do you mean, the bedroom door or the bathroom's door?

>bedroom
What do you want to unlock the bedroom door with?

>nothing
You can't see any such thing.

* * *

>e
The door is locked. You can hear the shower running, but no light is sifting through the door.

>SHOWME turning locker
Turning Locker - thing
location: the bathroom's door in The Landing
singular-named, improper-named; unlit, inedible, portable
list grouping key: none
printed name: "Turning Locker"
printed plural name: none
indefinite article: none
description: none
initial appearance: none

* * *

>e
The door is locked. You can hear the shower running, but no light is sifting through the door.

>x lock
You see nothing special about the Indicator Bolt Lock.

* * *

>e
The Landing
A small landing providing access to the rooms on the second floor of the house. To the right you can see the bathroom; you can tell the door have been locked from the inside from the old-fashioned bolt lock. You can see no light coming from the small glass pane above the door. The light is off as well, but you can hear the water in the shower running. Weird.

A plain-looking, creamy painted door leads back to the bedroom.

Another door leads to the bathroom. You can see a bolt lock next to the handle.

>x bathroom
You see nothing special about the bathroom door.

* * *

>e
The Landing
A small landing providing access to the rooms on the second floor of the house. To the right you can see the bathroom; you can tell the door have been locked from the inside from the old-fashioned bolt lock. You can see no light coming from the small glass pane above the door. The light is off as well, but you can hear the water in the shower running. Weird.

A plain-looking, creamy painted door leads back to the bedroom.

Another door leads to the bathroom. You can see a bolt lock next to the handle.

>x lock
You see nothing special about the bolt lock.

>x bathroom's door
You see nothing special about the bathroom's door.

>e
The door is locked. You can hear the shower running, but no light is sifting through the door.

* * *

>x lock
You see nothing special about the bolt lock.

>take lock
You can't reach it from this side. What would be the point otherwise?

* * *

>x lock
You see nothing special about the bolt lock.

>look at lock
You see nothing special about the bolt lock.

>describe
What do you want to describe?

>lock
What do you want to lock?

>describe lock
You see nothing special about the bolt lock.

* * *

>x lock
You see nothing special about the bolt lock.

>use lock
That's not a verb I recognise.

>get lock
You can't reach it from this side. What would be the point otherwise?

* * *

>e
The Landing
A small landing providing access to the rooms on the second floor of the house. To the right you can see the bathroom; you can tell the door have been locked from the inside from the old-fashioned bolt lock. You can see no light coming from the small glass pane above the door. The light is off as well, but you can hear the water in the shower running. Weird.

A plain-looking, creamy painted door leads back to the bedroom.

Another door leads to the bathroom. You can see a bolt lock next to the handle.

>take lock
The lock is tightly secured to the door and you can't seem to pull it off.

>x lock
You see nothing special about the bolt lock.

>turn lock
Nothing obvious happens.

>touch lock
You can't reach it from this side. What would be the point otherwise?.

You feel nothing unexpected.

* * *

>x lock
You see nothing special about the bolt lock.

>e
The door is locked. You can hear the shower running, but no light is sifting through the door.

* * *

>e
The Landing
A small landing providing access to the rooms on the second floor of the house. To the right you can see the bathroom; you can tell the door have been locked from the inside from the old-fashioned bolt lock. You can see no light coming from the small glass pane above the door. The light is off as well, but you can hear the water in the shower running. Weird.

A plain-looking, creamy painted door leads back to the bedroom.

Another door leads to the bathroom. You can see a bolt lock next to the handle.

>touch lock
Probably aluminium, but you can't be sure.

>x lock
You see nothing special about the bolt lock.

>take lock
The lock is tightly secured to the door and there's no way you can pull it out.
You can't reach it from this side. What would be the point otherwise?

* * *

>pick door
I didn't understand that sentence.

>take door
That's fixed in place.

* * *

>go
You'll have to say which compass direction to go in.

>e
The Landing
A small landing providing access to the rooms on the second floor of the house. To the right you can see the bathroom; you can tell the door have been locked from the inside because the old-fashioned turning lock is set on red. You can see no light coming from the small glass pane above the door; they probably did not even bother to raise the shutter. The light is off as well, but you can hear the water in the shower running. Weird.

A plain-looking, creamy painted door leads to the landing.

Another plain-looking, creamy painted door. You are starting to see a pattern here.

* * *

>l
Bedroom
You are in your room. It's got a strange vibe, as if each of the previous tenants left something of their own in it. But you got used to it, and now it's just your room. You are sitting at your tiny desk -- some oddly shaped table from IKEA or something -- staring at some text on the screen of your laptop. You have been trying to read the same paragraph for the last five minutes, but the words seem to be slipping away from you as soon as you hop from one to the next while playing your inner monologue.  To your left, the only painted wall stands out lonely; it's a dark blue, although the hue is light enough for the color to still be recognizable, at least in daylight. From outside, you can hear some birds chirping, and sunlight glides in through the large, wall-wide window behind you, gifting your back with a nice, cozy feeling of warmth. To the east the only door leads to a small landing.

A plain-looking, creamy painted door leads  to the landing.

>showme door
(the bedroom door)
bedroom door - open door
location: in the Bedroom
singular-named, improper-named; unlit, inedible, fixed in place; open, openable, unlocked
list grouping key: none
printed name: "bedroom door"
printed plural name: "doors"
indefinite article: none
description: none
initial appearance: "A plain-looking, creamy painted door leads  to the landing."
other side: The Landing

>e
The Landing
A small landing providing access to the rooms on the second floor of the house. To the right you can see the bathroom; you can tell the door have been locked from the inside from the old-fashioned bolt lock. You can see no light coming from the small glass pane above the door. The light is off as well, but you can hear the water in the shower running. Weird.

A plain-looking, creamy painted door leads back to the bedroom.

Another plain-looking, creamy painted door leads to the bathroom.

>x lock
You see nothing special about the Indicator Bolt Lock.

* * *

>knock
That's not a verb I recognise.

>x indicator lock
You can't see any such thing.